A	AH
A(2)	EY
ACTUALLY,	AE K CH AH W AH L IY
ALONE	AH L OW N
AM	AE M
AM(2)	EY EH M
BACK	B AE K
BLACK	B L AE K
BLUE	B L UW
BRIAN	B R AY AH N
BYE	B AY
COLOR	K AH L ER
COLOR(2)	K AO L ER
COULD	K UH D
FAVORITE	F EY V ER IH T
FAVORITE(2)	F EY V R AH T
FEEL	F IY L
FEELING	F IY L IH NG
FIND	F AY N D
FORWARD	F AO R W ER D
GEORGE	JH AO R JH
GO	G OW
GOOD	G UH D
GOOD(2)	G IH D
GOODBYE	G UH D B AY
GREEN	G R IY N
GREY	G R EY
HAVE	HH AE V
HELP	HH EH L P
HI	HH AY
I	AY
I'M	AY M
I'M(2)	AH M
IS	IH Z
Iâ€™M	IH M
KEVIN	K EH V IH N
KIND	K AY N D
LEFT	L EH F T
LIKE	L AY K
LONELY	L OW N L IY
LOST	L AO S T
MAN	M AE N
MARK	M AA R K
ME	M IY
MODE	M OW D
MOLLY	M AA L IY
MY	M AY
NAME	N EY M
NAVIGATE	N AE V AH G EY T
NAVIGATION	N AE V AH G EY SH AH N
NEED	N IY D
NOW,	N AW
OF	AH V
ORANGE	AO R AH N JH
ORANGE(2)	AO R IH N JH
PICTURE	P IH K CH ER
PLAY	P L EY
PUPPY	P AH P IY
PURPLE	P ER P AH L
REALLY	R IH L IY
REALLY(2)	R IY L IY
RED	R EH D
RESTART	R IY S T AA R T
RIGHT	R AY T
SAD	S AE D
STOP	S T AA P
THE	DH AH
THE(2)	DH IY
TO	T UW
TO(2)	T IH
TO(3)	T AH
USE	Y UW S
USE(2)	Y UW Z
VIOLET	V AY AH L IH T
WANT	W AA N T
WANT(2)	W AO N T
WAY?	W EY
WHITE	W AY T
WHITE(2)	HH W AY T
WING	W IH NG
WITH	W IH DH
WITH(2)	W IH TH
YELLOW	Y EH L OW
YOU	Y UW
ZACH	Z AE K
